11111111111111111111111
10C0101000C000100000001
10001000000000000000111
10000C0000000000E000001
10P00000000010000000111
10000000000000000000001
11111111111111111111111