1111111111111111111
1P00000000000000C01
10C0000000001000001
1000E00000001000001
1000000000000000001
1111111111111111111